1111111111111111111
1P01010000000000001
1001000000000000101
1000001000000000001
10101C0000000000001
1000000000000000011
1000001000000010111
10000000000000000E1
1000000000101000011
1111111111111111111