1111111111
1000000001
1E00000001
1000000001
10000C0001
1000000001
1000000001
1111111111