1111111111111111111
1P01010000000000001
100100010000X000101
1000001000000000001
10101C0000000000001
1000000000001000111
1000001000000010011
1000000000000000E01
1111111111111111111