1111111111111111111
1P00010000000000001
100000000100X000001
1000000000001000001
10000C0010000010001
1000000000000010001
1000001000000E10001
1111111111111111111